++++++++++++++++++++++
+   +   ++ ++        +
      +     ++++++++++
+ +    ++  ++++ +++ ++
+ +   + + ++    +++  +
+          ++  ++  + +
+++++ + +      ++  + +
++++++++++++++++++   +
   S            + +  +
+++++++++++++++    + +
++++++++++++++++++++++